1111111111
101001C011
1000000101
1P01E01001
1111111111